     ###########
    #     #f    #
   #  ###  # ##  ##
  #  ## ##  #  #   #
 #  #     #  #  ##  #
#  #  ###  #  # # # #
# #  #   #  # # # # #
# # #  # s# #     # #
# #  #  ##  # # # # #
#  #  #    #  # # # #
 #  #  ####  #  ##  #
  #  #      #  #   #
   #  ######  #  ##
    #       #   #
     ###########
