#######
#s    #
# # # #
#     #
# # # #
#    f#
#######
