###########################################
#s  #   #         #       #       # #     #
# # # # ####### # ##### # ### # # # # ### #
# #   #         #   #   #   # # # #     # #
# ################# # ##### ### # # ##### #
# #     #       #   # #         # #   #   #
# # ### # ##### # ### # ######### ##### # #
# #   #       # # #   # #       #       # #
# ### ######### # # ### # ##### ######### #
# #     #       #   #   #   # #   # #     #
# # ##### ################# # ### # # #####
# # #     #               #   #   # # #   #
# # # ##### ########### ##### # ### # # # #
#   #         #       #       #   #   # # #
# ########### ##### # ########### # ### # #
# #         #       #     #   #   #   # # #
### ####### ####### ####### # # ##### # ###
#   #     # #     # #       #   #   # #   #
# ### ### # # # ### # ########### ### ### #
#   #   # # # #     # #         #     #   #
### ### # # ### ##### # # ### ### ##### # #
#   #   # #   #   #   # # # # #   #     # #
# ### ####### ### # ### # # # # ### ##### #
# #         #   # #   # # # # #     #     #
# # ##### # ### # ### # # # # ####### #####
# #     # #   # #   # # #   # #       #   #
# ##### # # ### ##### # ##### # ### ### # #
# #   # # # #   #     #   # # #   # #   # #
# # # ### # # ### ####### # # ### # # ### #
#   #   # # # #   #       #       # #   # #
# ##### # ### # ### ############### ### # #
#     # #       #     #                 #f#
###########################################

